1111111111111
1000010000001
0011000000000
1000000000001
1000000000001
1000000000001
1000000000001
1000000000001
1000000000001
1000000000001
1111011111111