1111111111111
100P000000001
100000R0R0001
100000C000001
1000000000001
1000000000001
10E0000000001
1000000000001
1111111111111