1111111111111
100P000000001
100000R0R0011
100000C000011
1000000R00011
1000000000011
10E0000000011
1000000000011
1111111111111