0000000000000
00000P000R000
0000000000000
000R000000000
0000000000000
0000000000R00
000R000000000
0000000000000
1111111111111