0000000000R00
0P00000000000
00000R0000000
000000R000000
0000000000000
00R0000000000
0000000000R00
0000000000000
1111111111111