1111111111111
10P00000R0001
1000000000001
100000C000001
10R0000000001
10000000R0001
10E0000000001
1000000000001
1111111111111