11111
1CCC1
1E0P1
1R001
11111
